***************************
*............*............*
*.****.*****.*.*****.****.*
*O****.*****.*.*****.****O*
*.****.*****.*.*****.****.*
*.........................*
*.****.**.*******.**.****.*
*......**....*....**......*
******.*****.*.*****.******
******.**.......**.******
******.**.*******.**.******
..........**%#&**..........
******.**.*******.**.******
******.**.........**.******
******.**.*******.**.******
*............*............*
*.****.*****.*.*****.****.*
*O..**......@........**..O*
***.**.**.*******.**.**.***
*......**....*....**......*
*.**********.*.**********.*
*.........................*
***************************

